****************
*             E*
*****    *******
*              *
***   **** *****
*              *
****  ***  *****
*S             *
****************