**********
*        *
*    *   *
*  S * E *
*    *   *
*        *
*        *
**********